31 9
100 260
7 7 6 4 4 4 5 5 6 4 4 6 5 5 4 6 5 4 5 6 5 4 4 5 4 6 4 5 4 5 4
7 7 5 4 4 4 6 4 4 5 4 4 4 5 6 4 4 5 4 4 5 4 6 6 4 4 4 5 6 4 4
7 7 6 4 6 4 4 4 4 4 6 4 4 4 5 4 6 7 5 4 4 4 4 5 4 4 4 6 4 4 5
7 7 4 4 4 4 4 4 4 4 4 4 4 7 7 7 4 7 4 4 4 4 4 4 4 4 4 4 4 4 4
7 7 4 4 4 4 4 4 4 7 7 7 4 4 4 4 4 7 4 4 4 4 4 4 4 4 4 4 4 4 4
0 0 0 0 0 0 0 0 0 0 0 0 0 0 0 0 0 0 0 0 0 0 0 0 0 0 0 0 0 0 0
2 2 2 2 2 2 2 2 2 2 2 2 2 2 2 2 2 2 2 2 2 2 2 2 2 2 2 2 2 2 2
3 3 3 3 3 3 3 3 3 3 3 3 3 3 3 3 3 3 3 3 3 3 3 3 3 3 3 3 3 3 3
3 3 3 3 3 3 3 3 3 3 3 3 3 3 3 3 3 3 3 3 3 3 3 3 3 3 3 3 3 3 3